###########$##########################
#....................................#
#.........$..........................#
#...,.................,..............#
#....................................#
#....................................#
#........,......................,....#
#...........&........................#
#....................................#
#......,.............................#
#........................,...........#
#....................................#
#.........,..........................#
#....................................#
#....................,...............#
#....,...............................#
#...........,........................#
#...........................,........#
#....................................#
######################################