######################################
#....................................#
#.........$..........................#
#...,.................,..............#
#....................................#
#....................................#
#........,......................,....#
#...........,........................#
#....................................#
#......,.............................#
#........................,...........#
#....................................#
#.........,..........................#
#............................#.......#
#....................,...............#
#....,.......................$.......#
#...........,................&.......#
#...........................,........#
#....................................#
######################################