######################################
#....................................#
#.........$$$$$$$$$$$$...............#
#...,........$$$$$$...,..............#
#....................................#
#....................................#
#........,......................,....#
#...........,................$.......#
#....................................#
#......,.............................#
#........................,...........#
#....................................#
#.........,..........................#
#............................#.......#
#....................,...............#
#....,...............................#
#...&&&&....,..&&&&&&&&&&&&&&&.......#
#...........................,........#
#....................................#
######################################